Abhandlungen der Akademie der Wissenschaften in Mainz, Geistes- und Sozialwissenschaftliche Klasse	AAWM
Abhandlungen der Bayerischen Akademie der Wissenschaften, Philosophisch-historische Klasse	ABAW
Abhandlungen der Deutschen Akademie der Wissenschaften zu Berlin. Klasse für Sprachen, Literatur und Kunst	ADAW
Abhandlungen der Heidelberger Akademie der Wissenschaften, Philosophisch-historische Klasse	AHAW
Abhandlungen der Sachsischen Akademie der Wissenschaften zu Leipzig	ASAW
Accordia Research Papers	ARP
Acme	Acme
Acta ad Archaeologiam et Artium Historiam Pertinentia	AAAH
Acta Antiqua Academiae Scientiarum Hungaricae	AAntHung
Acta Archaeologica	AArch
Acta Archaeologica Academiae Scientiarum Hungaricae	AArchHung
Acta Classica	AClass
Acta Classica Universitatis Scientiarum Debreceniensis	ACD
Acta Historica Academiae Scientiarum Hungaricae	AHistHung
Acta Hyperborea	ActaHyp
Acta Iranica	AI
Acta Linguistica Academiae Scientiarum Hungaricae	ALingHung
Acta Orientalia Academiae Scientiarum Hungaricae	AOrientHung
Acta Patristica et Byzantina	APB
Acta Universitatis Szegediensis de Attila Jozsef Nominatae, Acta Historica	AHSzeged
Acta Universitatis Szegediensis de Attila József Nominatae, Acta Antiqua et Archaeologica	AAASzeged
Aegyptus	Aegyptus
Aevum	Aevum
Aevum Antiquum	Aevum(ant)
Africa	Africa
Akroterion	Akroterion
Akten der Gesellschaft für Griechische und Hellenistische Rechtsgeschichte	AGR
Alba Regia	Alba Regia
Alfinge	Alfinge
Allgemeine Zeitschrift für Philosophie	AZP
Ambix	Ambix
American Historical Review	AHR
American Journal of Ancient History	AJAH
American Journal of Archaeology	AJA
American Journal of Numismatics	AJN
American Journal of Philology	AJPh
American Numismatic Society Museum Notes	ANSMusN
American Philosophical Quarterly	APhQ
Ampurias	Ampurias
Anadolu (Anatolia)	Anadolu
Anadolu arastirmalari	AnAr
Analecta Bollandiana	AB
Analecta Malacitana	AMal
Analecta Papyrologica	APapyrol
Analecta Romana Instituti Danici	ARID
Analecta Sacra Tarraconensia	AST
Anales de filologia clásica	AFC
Anales de historia antigua y medieval	AHAM
Anales de la Universidad de Murcia, Facultad de Letras	AUM
Anas	Anas
Anatolia	Anatolia
Anatolian Studies	AS
Anatolica	Anatolica
Ancient History	AH
Ancient History Bulletin	AHB
Ancient Philosophy	AncPhil
Ancient Society	AncSoc
Ancient World	AncW
Anemos	Anemos
Anglo-Saxon England	ASE
Annales archéologiques arabes syriennes	AArchSyr
Annales d'histoire et d'archéologie de l'Université Saint-Joseph, Faculté des lettres et des sciences humaines	AHAUSJ
Annales de Bretagne et des Pays de l'Ouest	ABPO
Annales de l'Institut de philosophie de l'Université de Bruxelles	AIPh
Annales de l'Université de Paris	AUP
Annales de la Faculté des lettres et sciences humaines de l'Université de Dakar	AFLD
Annales de Normandie	AnnNorm
Annales du Service des antiquités de l'Égypte	ASAE
Annales Latini Montium Arvernorum	ALMArv
Annales Universitatis Scientiarum Budapestinensis de Rolando Eötvös Nominatae. Sectio Classica	AUB(class)
Annales Universitatis Scientiarum Budapestinensis de Rolando Eötvös Nominatae. Sectio Iuridica	AUB(jur)
Annales Universitatis Scientiarum Budapestinensis de Rolando Eötvös Nominatae. Sectio Philosophica et Sociologica	AUB(phil)
Annales valaisannes	AV
Annales: Économies, sociétés, civilisations	Annales (ESC)
Annales: Histoire, sciences sociales.	Annales (HSS)
Annali del Dipartimento di filosofia dell'Università di Firenze	ADFF
Annali del Liceo classico G. Garibaldi di Palermo	ALGP
Annali del Seminario giuridico della Università di Palermo	ASGP
Annali dell'Istituto di storia, Università di Firenze	AISF
Annali dell'Istituto italiano di numismatica	AIIN
Annali dell'Istituto italiano per gli studi storici	AIIS
Annali dell'Istituto universitario orientale di Napoli, Dipartimento di studi del mondo classico e del Mediterraneo antico, Sezione di archeologia e storia antica	AION(archeol)
Annali dell'Istituto universitario orientale di Napoli, Dipartimento di studi del mondo classico e del Mediterraneo antico, Sezione filologico-letteraria	AION(filol)
Annali dell'Istituto universitario orientale di Napoli, Dipartimento di studi del mondo classico e del Mediterraneo antico, Sezione linguistica	AION(ling)
Annali dell'Università di Ferrara. Nuova serie. Sezione V, Scienze giuridiche	AUFG
Annali dell'Università di Ferrara. Nuova Serie. Sezione VI, Lettere	AUFL
Annali della Facoltà di giurisprudenza, Università di Genova	AFGG
Annali della Facoltà di lettere di Lecce	AFLL
Annali della Facoltà di lettere e filosofia dell'Università di Cagliari	AFLC
Annali della Facoltà di lettere e filosofia dell'Università di Napoli	AFLN
Annali della Facoltà di lettere e filosofia dell'Università di Siena	AFLS
Annali della Facoltà di lettere e filosofia di Bari	AFLB
Annali della Facoltà di lettere e filosofia di Perugia	AFLPer
Annali della Facoltà di lettere e filosofia di Perugia. 1, Studi classici	AFLPer(class)
Annali della Facoltà di lettere e filosofia di Perugia. 2, Studi storico-antropologici	AFLPer(stor)
Annali della Facoltà di lettere e filosofia di Perugia. 3, Studi linguistici e letterari	AFLPer(linguist)
Annali della Facoltà di lettere e filosofia di Perugia. 4, Studi filosofici	AFLPer(filos)
Annali della Facoltà di lettere e filosofia, Università di Macerata	AFLM
Annali della Facoltà di magistero dell'Università di Cagliari	AFMC
Annali della Facoltà di scienze della formazione dell'Università di Cagliari	AFSFC
Annali della Scuola normale superiore di Pisa, Classe di lettere e filosofia	ASNP
Annali di storia dell'esegesi	AnnSE
Annali triestini	AnnTriest
Annuaire de l'École pratique des hautes études. IVe section, Sciences historiques & philologiques	AEHE (IVe sect.)
Annuaire de l'École pratique des hautes études. Ve section, Sciences religieuses	AEHE (Ve sect.)
Annuaire de l'Institut de philologie et d'histoire orientales et slaves de l'Université libre de Bruxelles	AIPhO
Annuaire de l'Université de Sofia, Faculté des lettres	AUS
Annuaire de la Société suisse de philosophie	ASSPh
Annuaire des amis de la Bibliothèque de Sélestat	AABS
Annuaire du Collège de France	ACF
Annuaire du Musée d'histoire de la religion et de l'athéisme	AMHR
Annual of the American Schools of Oriental Research	AASO
Annual of the British School at Athens	ABSA
Annuario del Ginnasio liceo A. Volta di Como	AGLComo
Annuario dell'Accademia etrusca di Cortona	AAEC
Annuario della Scuola archeologica di Atene a delle Missioni italiane in oriente	ASAA
Annuarium Historiae Conciliorum	AHC
Anregung	Anregung
Antaios	Antaios
Anthropos	Anthropos
Antichità altoadriatiche	AAAd
Antichthon	Antichthon
Anticnyj mir i arkheologija (Le monde antique et l'archéologie)	AMA
Antienaja drevnost'i srednije veka (L'antiquité et le moyen âge)	ADSV
Antigüedad y cristianismo	A&Cr
Antike Kunst	AK
Antike und Abendland	A&A
Antike Welt	AW
Antiqua	Antiqua
Antiquaries Journal	AntJ
Antiquitas	Antiquitas
Antiquité tardive	AntTard
Antiquités africaines	AntAfr
Antiquity	Antiquity
Antiquity and Survival	A&S
Antonianum	Antonianum
Anuari de filologia. Secció D, Studia Graeca et Latina	AFB
Anuario de historia del derecho español	AHDE
Anzeiger der Österreichischen Akademie der Wissenschaften in Wien, Philosophisch-historische Klasse	AAWW
Anzeiger für die Altertumswissenschaft	AAHG
Apeiron	Apeiron
Apocrypha	Apocrypha
Apollinaris	Apollinaris
Apollo	Apollo
Apollônia	Apollonia
Appunti romani de filologia	ARF
Aquileia nostra	AN
Aquitania	Aquitania
Aram Periodical	Aram
Arbor	Arbor
Arcadia	Arcadia
Archaeologia, or Miscellaneous tracts relating to Antiquity	Archaeologia
Archaeologiai Értesítö	AErt
Archaeological Journal	AJ
Archaeological News	ArchN
Archaeological Reports	AR
Archaeology	Archaeology
Archaeonautica	Archaeonautica
Archaiognôsia	Archaiognosia
Archaiologikè ephèmeris	AEph
Archaiologikon deltion	AD
Archäologie der Schweiz	ArchS
Archäologie im Kanton Bern	AKBern
Archäologischer Anzeiger	AA
Archäologisches Korrespondenzblatt	AKB
Archeion oikonomikès istorias (Archives of Economic History)	AEH
Archeologia	Archeologia
Archeologia classica	ArchClass
Archéologie	Arch (Sofia)
Architectura	Architectura
Archiv für Begriffsgeschichte	ABG
Archiv für Geschichte der Philosophie	AGPh
Archiv für Kulturgeschichte	AKG
Archiv für Musikwissenschaft	AMW
Archiv für Orientforschung	AOF
Archiv für Papyrusforschung und verwandte Gebiete	APF
Archiv für Philosophie	ArchivPhilos
Archiv für Religionsgeschichte	ARG
Archiv orientalni	ArchOrient
Archive for History of Exact Sciences	AHES
Archives d'histoire doctrinale et littéraire du Moyen Âge	AHMA
Archives de philosophie	ArchPhilos
Archives de philosophie du droit	APhD
Archives internationales d'histoire des sciences	AIHS
Archivio giuridico	AG
Archivio glottologico italiano	AGI
Archivio storico italiano	ASI
Archivio storico per la Calabria e la Lucania	ASCL
Archivio storico per la Sicilia orientale	ASSO
Archivio storico pugliese	ASP
Archivio storico sardo	ASSard
Archivio storico siciliano	ASS
Archivo español de arqueología	AEA
Archivum Latinitatis Medii Aevi (Bulletin Du Cange)	ALMA
Archivum Linguisticum	ALing
Arctos	Arctos
Arethusa	Arethusa
Argos	Argos
Arheologiâ	Arh
Arheoloski vestnik (Acta Archaeologica)	AArchSlov
Ariadne	Ariadne
Arion	Arion
Arkheologija	ArkUkr
Art Bulletin	ABull
Asclepio	Asclepio
Atene e Roma	A&R
Athenaeum	Athenaeum
Athèna	Athena
Atiqot. English Series	Atiqot
Atti del Centro Ricerche e documentazione sull'antichittà classica	CRDAC
Atti del Sodalizio glottologico milanese	ASGM
Atti dell'Accademia di scienze lettere e arti di Palermo. 2, Lettere	AAPal
Atti dell'Accademia ligure di scienze e lettere	AALig
Atti dell'Accademia pontaniana	AAP
Atti dell'Istituto veneto di scienze, lettere ed arti, Classe di scienze morali e lettere	AIV
Atti della Accademia delle scienze di Torino. 2, Classe di scienze morali, storiche e filologiche	AAT
Atti della Accademia di scienze morali e politiche della Società nazionale di scienze, lettere ed arti di Napoli	AAN
Atti della Accademia mediterranea delle scienze	AAMed
Atti della Accademia peloritana dei pericolanti, Classe di lettere, filosofia e belle arti	AAPel
Atti della Accademia roveretana degli agiati, Classe di scienze umane, lettere ed arti	AARov
Atti della Pontificia accademia romana di archeologia. Serie IIIa, Memorie (in-4°)	MPAA
Atti e memorie dell'Accademia patavina di scienze, lettere ed arti. 3, Memorie della Classe di scienze morali, lettere ed arti	AAPat
Atti e memorie dell'Accademia toscana La Colombaria	AATC
Atti e memorie dell'Arcadia	AMArc
Atti e memorie della Accademia di agricoltura, scienze e lettere di Verona	AMAV
Atti e memorie della Accademia virgiliana di Mantova	AVM
Atti e memorie della Società istriana di archeologia e storia patria	AMSI
Atti e memorie della Società Magna Grecia	ASMG
Aufidus	Aufidus
Aufstieg und Niedergang der römischen Welt	ANRW
Augustan Age	AugAge
Augustinian Studies	AugStud
Augustiniana	Augustiniana
Augustinianum	Augustinianum
Augustinus	Augustinus
AUMLA: Journal of the Australasian Universities Language and Literature Association	AUMLA
Baseler Zeitschrift für Geschichte und Altertumskunde	BZG
Bayerische Vorgeschichtsblätter	BVBl
Beiträge zur allgemeinen und vergleichenden Archäologie	BAVA
Beiträge zur Namenforschung	BN
Belfagor	Belfagor
Berceo	Berceo
Bericht der Römisch-Germanischen Kommission des Deutschen Archäologischen Instituts	BRGK
Bericht über die Tagung für Ausgrabungswissenschaft und Bauforschung, Koldewey-Gesellschaft	KGB
Berichte zur Wissenschaftsgeschichte	BWG
Berytus	Berytus
Biblica	Biblica
Bibliotheca Classica Orientalis	BCO
Bibliotheca Orientalis	BO
Bibliothek und Wissenschaft	B&W
Bibliothèque d'humanisme et Renaissance	BiblH&R
Bibliothèque de l'École des chartes	BECh
Biblische Zeitschrift	BiZ
Biblos	Biblos
Bodleian Library Record	BLR
Boletim de estudos clássicos	BEC
Boletín del Museo Arqueológico Nacional	BMAN
Boletín del Museo de Zaragoza	BMZ
Boletín del Seminario de Estudios de Arte y Arqueología	BSEAA
Bolletino del Centro internazionale per lo studio dei papyri ercolanesi (Cronache ercolanesi)	BCPE
Bollettino d'arte del Ministero per i beni culturali e ambientali	BA
Bollettino dei classici	BollClass
Bollettino dei monumenti, musei e gallerie pontificie	BMMP
Bollettino del Comitato per la preparazione dell'edizione nazionale dei classici greci e latini	BPEC
Bollettino dell'Istituto centrale del restauro	BICR
Bollettino dell'Istituto di diritto romano	BIDR
Bollettino di numismatica	BNum
Bollettino di studi latini	BStudLat
Bolskan	Bolskan
Bonner Jahrbücher	BJ
Boreas	Boreas
Britannia	Britannia
British Archaeological Abstracts	BritAA
British Journal for the History of Philosophy	BJHP
British Journal for the History of Science	BJHS
British Numismatic Journal	BNJ
Bryn Mawr Classical Review	BMCRev
Bulletin antieke beschaving	BABesch
Bulletin archéologique du Comité des travaux historiques et scientifiques	BCTH
Bulletin archéologique du Comité des travaux historiques et scientifiques. Série A, Antiquités nationales	BCTH(A)
Bulletin archéologique du Comité des travaux historiques et scientifiques. Série B, Afrique du Nord	BCTH(B)
Bulletin critique du livre français	BCLF
Bulletin d'archéologie algérienne	BAA
Bulletin d'archéologie et d'architecture libanaises	BAAL
Bulletin d'archéologie marocaine	BAM
Bulletin d'études orientales	BEO
Bulletin d'information de l'Association internationale pour l'étude de la mosaïque antique	BullAIEMA
Bulletin d'information de l'Institut de recherche de d'histoire des textes	BIRT
Bulletin de correspondance hellénique	BCH
Bulletin de l'Association Guillaume Budé	BAGB
Bulletin de l'Institut archéologique bulgare	BIAB
Bulletin de l'Institut d'Égypte	BIE
Bulletin de l'Institut français d'archéologie orientale	BIAO
Bulletin de l'Institut historique belge de Rome	BIBR
Bulletin de la Classe des lettres de l'Académie royale de Belgique	BAB
Bulletin de la Faculté des lettres de Mulhouse	BFLM
Bulletin de la Faculté des lettres de Strasbourg	BFS
Bulletin de la Société d'archéologie d'Alexandrie	BSAA
Bulletin de la Société de linguistique de Paris	BSL
Bulletin de la Société des antiquaires de l'Ouest	BSAO
Bulletin de la Société française de numismatique	BSFN
Bulletin de la Société française de philosophie	BSPh
Bulletin de la Société internationale pour l'étude de la philosophie médiévale	BPhM
Bulletin de la Société nationale des antiquaires de France	BSAF
Bulletin de la Société toulousaine d'études classiques	BSTEC
Bulletin de littérature ecclésiastique	BLE
Bulletin de théologie ancienne et médiévale	BTh
Bulletin des antiquités luxembourgeoises	BAL
Bulletin des bibliothèques de France	BBF
Bulletin des Musées royaux d'art et d'histoire	BMAH
Bulletin du Musée de Beyrouth	BMB
Bulletin monumental	BM
Bulletin of the American Schools of Oriental Research	BASO
Bulletin of the American Society of Papyrologists	BASP
Bulletin of the Egyptological Seminar	BES
Bulletin of the History of Medicine	BHM
Bulletin of the Institute of Archaeology of the University of London	BIAL
Bulletin of the Institute of Classical Studies of the University of London	BICS
Bulletin of the John Rylands Library	BRL
Bulletin of the Museum of Fine Arts in Boston	BMusB
Bulletin of the Museum of Mediterranean and Near Eastern Antiquities	BMNE
Bulletin of the Museums of Art and Archaeology of the University of Michigan	BMusUM
Bulletin semestriel de l'Association des classiques de l'Université de Liège	BAClLg
Bulletin trimestriel de la Société de géographie et d'archéologie d'Oran	BSGAO
Bulletin trimestriel de la Société des antiquaires de Picardie	BSAP
Bulletin van de Vereeniging tot Bevordering der Kennis van de Antieke Beschaving	BVAB
Bullettino della Commissione archeologica comunale di Roma	BCAR
Byzantinische Forschungen	ByzF
Byzantinische Zeitschrift	ByzZ
Byzantinoslavica	ByzSlav
Byzantion	Byzantion
Caesaraugusta	Caesaraugusta
Caesarodunum	Caesarodunum
Cahiers alsaciens d'archéologie, d'art et d'histoire	CAAH
Cahiers archéologiques: Fin de l'antiquité et Moyen âge	CArch
Cahiers d'histoire	CH
Cahiers d'histoire mondiale	CHM
Cahiers de Byrsa	Byrsa
Cahiers de civilisation médiévale	CCM
Cahiers de l'Institut de linguistique de Louvain	CILL
Cahiers de l'Institut du moyen âge grec et latin	CIMAGL
Cahiers de philosophie politique et juridique	CPhPJ
Cahiers de recherches de l'Institut de papyrologie et d'égyptologie de Lille	CRIPEL
Cahiers des études anciennes	CEA
Cahiers du Centre d'études chypriotes	CCEC
Cahiers du Centre George-Radet	CCGR
Cahiers du Centre Gustave-Glotz	CCG
Cahiers du Groupe interdisciplinaire du théâtre antique	CGITA
Cahiers Ferdinand de Saussure	CFS
Cahiers numismatiques	CahNum
Cambridge Archaeological Journal	CArchJ
Canadian Journal of Philosophy	CJPh
Canadian Philosophical Reviews	CPhRev
Canadian Review of Comparative Literature	CRCL
Cassiodorus	Cassiodorus
Catholic Historical Review	CHR
Centaurus	Centaurus
Centre d'études et de documentation archéologique de la Conservation de Carthage. Bulletin	CEDAC
Césure	Césure
Chiron	Chiron
Chronique d'Égypte	CE
Chronos	Chronos
Chronozones	Chronozones
Church History	ChHist
Ciceroniana	Ciceroniana
Civiltà classica e cristiana	CCC
Classica	Classica (Lisboa)
Classica et Mediaevalia	C&M
Classica Wratislaviensia	ClassWrat
Classical and Modern Literature	CML
Classical Antiquity	ClAnt
Classical Bulletin	CB
Classical Folia	CF
Classical Journal	CJ
Classical Outlook	CO
Classical Philology	CPh
Classical Quarterly	CQ
Classical Review	CR
Classical Studies	ClassStud
Classical World	CW
Classics Ireland	Classics Ireland
Clio Medica	CM
Codices Manuscripti	CodMan
Colby Quarterly	ColbyQ
Communications du Musée national de l'Ermitage	ComErm
Comparative Literature	CompLit
Comparative Literature Studies	CLS
Comparative Studies in Society and History	CSSH
Comptes rendus de l'Académie des inscriptions et belles-lettres	CRAI
Computers and the Humanities	CHum
Conimbriga	Conimbriga
Connaissance hellénique	ConnHell
Contributi dell'Istituto di storia antica dell'Università del Sacro Cuore	CISA
Corolla Londiniensis	CL
Cristianesimo nella storia	CrSt
Critica storica	CS
Cronache ercolanesi	CErc
Cuadernos de filología clásica	CFC
Cuadernos de filología clásica. Estudios griegos e indoeuropeos	CFC(G)
Cuadernos de filología clásica. Estudios latinos	CFC(L)
Cuadernos de investigación filológica	CIF
Cuadernos de prehistoria i arqueología	CPAM
Cudas	Cudas
Cultura e scuola	C&S
Dacia	Dacia
Dacoromania	Dacoromania
Damaszener Mitteilungen	MDAI(D)
Das Altertum	Altertum
Delta	Delta
Der altsprachliche Unterricht	AU
Der Anschnitt	Anschnitt
Deukalion	Deukalion
Deutsche Literaturzeitung für Kritik der internationalen Wissenschaft	DLZ
Deutsches Dante-Jahrbuch	DDJ
Dialectica	Dialectica
Dialoghi di archeologia	DArch
Dialogue	Dialogue
Dialogues d'histoire ancienne	DHA
Die alte Stadt	AStadt
Die Sprache	Sprache
Die Welt als Geschicte	WG
Die Welt des Orients	WO
Dike	Dike
Diogène	Diogène
Dioniso	Dioniso
Dionysius	Dionysius
Diotima	Diotima
Discorsi	Discorsi
Dissertation Abstracts International	DA
Documenti e studi sulla tradizione filosofica medievale	DSTradF
Dodone	Dodone
Downside Review	DR
Drevnejsije gosudarstva na territorii SSSR (Les États les plus anciens sur le territoire de l'URSS)	DGT
Dumbarton Oaks Papers	DOP
Durham University Journal	DUJ
Dynamis	Dynamis
East and West	E&W
Egitto e Vicino Oriente	EVO
Egnatia	Egnatia
Eikasmos	Eikasmos
Eirene	Eirene
Ekklesiastikos pharos	EPharos
Electronic Antiquity	ElectronAnt
Elenchos	Elenchos
Emerita	Emerita
Empúries	Empúries
Enchoria	Enchoria
English Historical Review	EHR
Ensaios de literatura e filologia	ELF
Eos	Eos
Epetèris tès Hetaireias Èliakôn Meletôn	EHEM
Epetèris tès Kentrou Ereunès tès Historias tou Hellènikou Dikaiou	EHHD
Ephemerides Theologicae Lovanienses	EThL
Epigraphica	Epigraphica
Epigraphica Anatolica	EA
Epimeleia	Epimeleia
Epistèmonikè epetèrida tès Philosophikès Scholès tou Aristoteleiou Panepitèmiou Thessalonikès, Tmèma filosofias	EEThess(philos)
Epistèmonikè epetèris tès Philosophikès Scholès tou Panepistèmiou Athènôn	EEAth
Er: Revista de filosofía	Er
Eranos	Eranos
Eranos-Jahrbuch	Eranos-Jb
Erasmus	Erasmus
Espacio, tiempo y forma. Serie 1, Prehistoria y arqueología	ETF(arqueol)
Espacio, tiempo y forma. Serie 2	ETF(hist)
Estudios bíblicos	EB
Estudios clásicos	EClás
Estudios de la antigüedad	EstAnt
Estudios humanísticos. Filología	EHum
Ethnographisch-archäologische Zeitschrift	EAZ
Etruscan Studies	EtrStud
Eudikia	Eudikia
Eunomia	Eunomia
Euphrosyne	Euphrosyne
Eurasia Antiqua	EurAnt
Euresis	Euresis
Eutopia	Eutopia
Excerpta Philologica	ExcPhilol
Échos du monde classique (Classical Views)	EMC
Église et théologie	E&Th
Études celtiques	EC
Études de lettres	EL
Études de papyrologie	EPap
Études indo-européennes	EIE
Études philosophiques	EPh
Études savoisiennes	ESav
Études suisses d'histoire générale	ESHG
Études théologiques et religieuses	EThR
Fabula	Fabula
Faventia	Faventia
Felix Ravenna	FR
Filologia antica e moderna	FAM
Filología neotestamentaria	FNT
Filosofia	Filosofia
Florentia Iliberritana	FlorIlib
Florilegium	Florilegium
Folia	Folia
Fonaments	Fonaments
Fontes: Rivista di filologia, iconografia e storia della tradizione classica	Fontes
Forschungen und Fortschritte	F&F
Fortunatae	Fortunatae
Forum der Letteren	FL
Forum lulii	FIul
Francia	Francia
Freiburger Zeitschrift für Philosophie und Theologie	FZPhTh
Frühmittelalterliche Studien	FMS
Fundberichte aus Baden-Wurttemberg	FBW
Gallaecia	Gallaecia
Gallia	Gallia
Gazette des beaux-arts	GBA
Genava	Genava
Geographia Antiqua	GeogrAnt
Geographical Journal	GJ
Gerión	Gerión
Germania	Germania
Geschichte in Wissenschaft und Unterricht	GWU
Gesnerus	Gesnerus
Giornale critico della filosofia italiana	GCFI
Giornale di metafisica	GM
Giornale ferrarese di retorica e filologia	GFRF
Giornale italiano di filologia	GIF
Glotta	Glotta
Gnomon	Gnomon
Göttinger Forum für Altertumswissenschaft	GFA
Göttingische gelehrte Anzeigen	GGA
Graecolatina et Orientalia	GLO
Graecolatina Pragensia	GLP
Grazer Beiträge	GB
Greece and Rome	G&R
Greek, Roman and Byzantine Studies	GRBS
Gregorianum	Gregorianum
Gymnasium	Gymnasium
Habis	Habis
Hamburger Beiträge zur Archäologie	HBA
Hamburger Beiträge zur Numismatik	HBN
Harvard Library Bulletin	HLB
Harvard Studies in Classical Philology	HSPh
Harvard Theological Review	HThR
Hebrew Union College Annual	HebrUCA
Hefte des Archäologischen Seminars der Universität Bern	HASB
Helikon	Helikon
Helios	Helios
Hellas	Hellas
Hellènika	Hellenica
Helmantica	Helmantica
Helvetia Archaeologica	HA
Hephaistos	Hephaistos
Hermathena	Hermathena
Hermeneus	Hermeneus
Hermes	Hermes
Hesperia	Hesperia
Hespéris	Hespéris
Hibbert Journal	HibJ
Hippokrates	Hippokrates
Hispania	Hispania
Hispania Antiqua	HAnt
Histoire des sciences médicales	HSMed
Histoire, épistémologie, langage	HEL
Historia	Historia
Historia Mathematica	HM
Historische Sprachforschung (Historical Linguistics)	HSF
Historische Zeitschrift	HZ
Historisches Jahrbuch	HJ
History	History
History and Philosophy of the Life Sciences	HPLS
History and Theory	H&T
History of Philosophy Quarterly	HPhQ
History of Political Thought	HPTh
History of Religions	HR
History of Science	HS
History of Technology	HTechn
Histos	Histos
Homonoia	Homonoia
Hormos	Hormos
Horos	Horos
Humanidades	Humanidades
Humanistica Lovaniensia	HumLov
Humanitas: Revista do Instituto de Estudos Clássicos, Universidade de Coimbra	Humanitas (Coimbra)
Humanitas: Rivista bimestrale di cultura	Humanitas (Brescia)
Humanités	Hum(RES)
Humanística	Humanística
Hyperboreus	Hyperboreus
Il pensiero politico	PPol
Illinois Classical Studies	ICS
Incontri linguistici	ILing
Index	Index
Indogermanische Forschungen	IF
International Journal of Musicology	IJM
International Journal of Nautical Archaeology	IJNA
International Journal of Philosophical Studies	IJPS
International Journal of the Classical Tradition	IJCT
International Philosophical Quarterly	IPQ
International Studies in Philosophy	ISPh
Interpretation	Interpretation
Invigilata Lucernis	InvLuc
Iran	Iran
Iranica Antiqua	IA
Iraq	Iraq
Isis	Isis
Israel Exploration Journal	IEJ
Istanbuler Mitteilungen	MDAI(I)
Istoriko-filosofsky ezegodnik (History of Philosophy Yearbook)	IFE
Itaca	Itaca
Italia medioevale e umanistica	IMU
Italica	Italica
Iura	Iura
J. Paul Getty Museum Journal	GMusJ
Jaarbericht van het Voor-Aziatisch-Egyptisch Genootschap Ex Oriente Lux	JVEG
Jahrbuch der Berliner Museen	JBerlM
Jahrbuch der Heidelberger Akademie der Wissenschaften	JHAW
Jahrbuch der Österreichischen Byzantinistik	JÖByz
Jahrbuch der Schweizerischen Gesellschaft für Ur- und Frühgeschichte	JSGU
Jahrbuch des Bernischen Historischen Museums	JBM
Jahrbuch des Deutschen Archäologischen Instituts	JDAI
Jahrbuch des Römisch-Germanischen Zentralmuseums Mainz	JRGZ
Jahrbuch für Antike & Christentum	JbAC
Jahrbuch für kleinasiatische Forschung	JKAF
Jahrbuch für Numismatik und Geldgeschichte	JNG
Jahrbuch für Religionswissenschaft und Theologie der Religionen	JRTR
Jahrbuch für Wirtschaftsgeschichte	JWG
Jahresberichte aus Augst und Kaiseraugst	JAK
Jahreshefte des Österreichischen Archäologischen Instituts in Wien	JÖAI
Janus	Janus
Journal asiatique	JA
Journal des savants	JS
Journal for the History of Arabic Science	JHAS
Journal for the History of Astronomy	JHA
Journal for the Study of Judaism in the Persian, Hellenistic and Roman Period	JSJ
Journal of Ancient Civilization	JAC
Journal of Biblical Literature	JBL
Journal of Classical Studies	JCS
Journal of Early Christian Studies	JECS
Journal of Ecclesiastical History	JEH
Journal of Egyptian Archaeology	JEA
Journal of European Archaeology	JEurArch
Journal of Field Archaeology	JFA
Journal of Glass Studies	JGS
Journal of Greco-Roman Studies	JGRS
Journal of Hellenic Studies	JHS
Journal of Indo-European Studies	JIES
Journal of Juristic Papyrology	JJP
Journal of Mediterranean Archaeology	JMA
Journal of Near Eastern Studies	JNES
Journal of Neoplatonic Studies	JNStud
Journal of Philosophy	JPh
Journal of Prehistoric Religion	JPR
Journal of Religion	JR
Journal of Religious History	JRH
Journal of Roman Archaeology	JRA
Journal of Roman Military Equipment Studies	JRMES
Journal of Roman Studies	JRS
Journal of the American Oriental Society	JAOS
Journal of the American Research Center in Egypt	JARCE
Journal of the British Archaeological Association	JBAA
Journal of the Economic and Social History of the Orient	JESHO
Journal of the History of Biology	JHB
Journal of the History of Ideas	JHI
Journal of the History of Medicine and Allied Sciences	JHM
Journal of the History of Philosophy	JHPh
Journal of the History of Sexuality	JHSex
Journal of the Royal Asiatic Society	JAS
Journal of the Society of Architectural Historians	JSAH
Journal of the Walters Art Gallery	JWAG
Journal of the Warburg and Courtauld Institutes	JWI
Journal of Theological Studies	JThS
Kadmos	Kadmos
Kairos	Kairos
Kalathos	Kalathos
Kant-Studien	KantStud
Karthago	Karthago
Kentron	Kentron
Kernos	Kernos
Klearchos	Klearchos
Kleio	Kleio
Kleos	Kleos
Klio	Klio
Kodai	Kodai
Koinônia	Koinonia
Koroth	Koroth
Kölner Jahrbuch	KJ
Kôkalos	Kokalos
Kratylos	Kratylos
Kriterion	Kriterion
Ktèma	Ktèma
Kul'tura iskusstvo anticnogo mira	KIAM
L'année philologique	APh
L'antiquité classique	AC
L'écrit du temps	Edt
L'homme	L'Homme
L'information grammaticale	IG
L'information historique	IH
L'information littéraire	IL
l'Italia dialettale	ID
La linguistique	Ling
La nouvelle Clio	NClio
La parola del passato	PP
La pensée	La Pensée
La revue des arts	RArts
Labeo	Labeo
Lalies	Lalies
LAMA: Documents du Centre de recherches comparatives sur les langues de la Méditerranée ancienne	LAMA
Lampadion	Lampadion
Lampas	Lampas
Langages	Langages
Language	Language
Lateranum	Lateranum
Latinitas	Latinitas
Latomus	Latomus
Laval théologique et philosophique	LThPh
Laverna	Laverna
Le genre humain	GH
Le Moyen Âge	MA
Le parole e le idee	P&I
Le temps de la réflexion	TR
Les cahiers de Tunisie	CT
Les études classiques	LEC
Levant	Levant
Lexis	Lexis
Libya Antiqua	LibAnt
Libyan Studies	LibStud
Libyca	Libyca
Limes	Limes
Lingua	Lingua
Lingua e stile	L&S
Linguistica Biblica	LingBibl
Listy filologické	LF
Litterae Numismaticae Vindobonenses	LNV
Littérature, médecine et société	LMS
Liverpool Classical Monthly	LCM
Lucentum	Lucentum
Lustrum	Lustrum
Lychnos	Lychnos
Madrider Mitteilungen	MDAI(M)
Maia	Maia
Mainzer archäologische Zeitschrift	MAZ
Mainzer Zeitschrift	MZ
Manuscripta	Manuscripta
Materiali e contributi per la storia della narrativa greco-latina	MCSN
Materiali e discussioni per l'analisi dei testi classici	MD
Meander	Meander
Mededelingen van de Koninklijke Academie voor Wetenschappen, Letteren & Schone Kunsten van België, Klasse der Letteren	MAWBL
Mededelingen van het Nederlands Instituut te Rome	MNIR
Mediaeval and Renaissance Studies	MRS
Mediaeval Studies	MS
Mediaevalia et Humanistica	M&H
Medical History	MedHist
Medioevo greco	MEG
Mediterranean Archaeology	MedArch
Mediterranean Historical Review	MHR
Mediterraneo antico	MediterrAnt
Mediterraneus	Mediterraneus
Medium Aevum	MAev
Medizinhistorisches Journal	MHJ
Memoirs of the American Academy in Rome	MAAR
Memorias de historia antigua	MHA
Memorie dell'Accademia delle scienze dell'Istituto di Bologna, Classe di scienze morali	MAIB
Memorie dell'Accademia delle scienze di Torino, Classe di scienze morali, storiche e filologiche	MAT
Memorie dell'Istituto Lombardo	MIL
Memorie della Classe di scienze morali e storiche dell'Accademia dei Lincei	MAL
Meroitica	Meroitica
Mesopotamia	Mesopotamia
Messana	Messana
Metalogicon	Metalogicon
Metropolitan Museum Journal	MMJ
Metropolitan Museum of Art Bulletin	BMM
Mélanges d'archéologie et d'histoire de l'École française de Rome	MEFR
Mélanges de l'École française de Rome. Antiquité	MEFRA
Mélanges de l'École française de Rome. Moyen âge	MEFRM
Mélanges de l'Université Saint-Joseph	MUSJ
Mélanges de la Casa de Velazquez	MCV
Mélanges de science religieuse	MSR
Mémoires de l'Académie des Inscriptions et Belles Lettres	MAI
Méthexis	Méthexis
Métis	Métis
Militärgeschichtliche Mitteilungen	MGM
Militärgeschichtliche Zeitung	MGZ
Mind	Mind
Minerva: Revista de filologia clásica	Minerva (Valladolid)
Minerva: The International Review of Ancient Art and Archaeology	Minerva (London)
Minos	Minos
MIscellanea di studi di letteratura cristiana antica	MSLC
Miscellanea greca e romana	MGR
Mitteilungen der Archäologischen Gesellschaft Steiermark	MAGS
Mitteilungen des Deutschen Archäologischen Instituts, Athenische Abteilung	MDAI(A)
Mitteilungen des Deutschen Archäologischen Instituts, Römische Abteilung	MDAI(R)
Mitteilungen des Instituts für Österreichische Geschichtsforschung	MIÖG
Mitteilungen zur christlichen Archäologie	MiChA
Mittellateinisches Jahrbuch	MLatJb
Mnemosyne	Mnemosyne
Modern Schoolman	ModSch
Monumenti antichi	MonAL
Monuments archéologiques en Ukraine	ArkMon
Monuments et mémoires publiés par l'Académie des Inscriptions et Belles-Lettres, Fondation Eugène Piot	MMAI
Munibe	Munibe
Museum	MPh
Museum Criticum	MCr
Museum Helveticum	MH
Museum Patavinum	MusPat
Museum Philologum Londiniense	MPhL
Museum Tusculanum	MT
Muséon	Muséon
Münchener Studien zur Sprachwissenschaft	MSS
Münstersche Beiträge zur antiken Handelsgeschichte	MBAH
Myrtia	Myrtia
Mythos	Mythos
Nachrichten der Akademie der Wissenschaften in Göttingen. Philolosophisch-historische Klasse	NAWG
Nachrichten von der Gesellschaft der Wissenschaften zu Göttingen. Philologisch-historische Klasse	NGG
Neophilologus	NPh
Nestor	Nestor
Neuphilologische Mitteilungen	NPhM
New England Classical Newsletter	NECN
New Testament Abstracts	NTA
New Testament Studies	NTS
Nicolaus	Nicolaus
Nikephoros	Nikephoros
Notices d'archéologie armoricaine	NAA
Notizie degli scavi di antichità	NSA
Nouvelle revue théologique	NRTh
Nova Tellus	Nova Tellus
Novum Testamentum	NT
NTM: Internationale Zeitschrift für Geschichte und Ethik der Naturwissenschaften, Technik und Medizin	NTM
Nubica	Nubica
Nueva revista de filologia hispánica	NRFH
Numen	Numen
Numisma	Numisma
Numismatic Chronicle	NC
Numismatic Circular	NCirc
Numismatic Literature	NL
Numismatica	Numismatica
Numismatica e antichità classiche	NAC
Numismatika i èpigraphika	NÈ
Numismatische Zeitschrift	NZ
Numismatisches Nachrichtenblatt	NNB
Nuova rivista storica	NRS
Nuovi annali della Facoltà di magistero dell'Università di Messina	NAFM
Nuovo didaskaleion	ND
Oikumene	Oikumene
Opus	Opus
Opuscula Atheniensia	OAth
Opuscula Romana	ORom
Orbis	Orbis
Orbis Terrarum	OTerr
Oriens	Oriens
Oriens Antiquus	OA
Oriens Christianus	OC
Oriens-Occidens	Oriens-Occidens
Orient	Orient
Orientalia	Orientalia
Orientalia Christiana Periodica	OCP
Orientalia Lovaniensia Periodica	OLP
Orientalistische Literaturzeitung	OLZ
Orphea Voce	Orphea voce
Orpheus	Orpheus
Osiris	Osiris
Ostkirchliche Studien	OS
Ostraka	Ostraka
Oudheidkundige mededelingen uit het Rijksmuseum van Oudheiden te Leiden	OMRL
Oxford Journal of Archaeology	OJA
Oxford Studies in Ancient Philosophy	OSAPh
Paideia	Paideia
Palestine Exploration Quarterly	PalEQ
Palladio	Palladio
Pallas	Pallas
Pan	Pan
Papers of the British School at Rome	PBSR
Papyrologica Lupiensia	PapLup
Paris et Ile-de-France	P&IF
Parnassos	Parnassos
Parole de l'Orient	POr
Parousia	Parousia
Past and Present	P&P
Patavium	Patavium
Pegasus	Pegasus
Perficit	Perficit
Perspektiven der Philosophie	PPh
Petronian Society Newsletter	PSN
Pharmacy in History	PhH
Philologia Classica	PhilClass
Philological Quarterly	PhQ
Philologus	Philologus
Philosophia	Philosophia
Philosophia Naturalis	PhN
Philosophical Books	PhB
Philosophical Forum	PF
Philosophical Quarterly	PhilosQ
Philosophical Review	PhR
Philosophical Studies	PhStud
Philosophie antique	PhilosAnt
Philosophiques	Philosophiques
Philosophische Rundschau	PhRdschau
Philosophischer Literaturanzeiger	PhLA
Philosophisches Jahrbuch	PhJ
Philosophy	Philosophy
Philosophy and Literature	Ph&Lit
Philosophy and Phenomenological Research	Ph&PhenR
Philosophy and Rhetoric	Ph&Rh
Philosophy in Review	PhRev
Phoenix	Phoenix
Phoibos	Phoibos
Phronesis	Phronesis
Physis	Physis
Picus	Picus
Pitannâ klasicnoï filologìï (Questions de philologie classique)	PKFìl
Platôn	Platon
Ploutarchos	Ploutarchos
Poetica	Poetica
Poikilia	Poikilia
Polemôn	Polemon
Polifemo	Polifemo
Polis	Polis
Praktika tès Akadèmias Athènôn	PAA
Praktika tès en Athènais Archaiologikès Hetaireias	PAAH
Préhistoire	Préhistoire
Priroda (La nature)	Priroda
Pro Aventico	Pro Aventico
Pro Vindonissa	Pro Vindonissa
Proceedings of the African Classical Association	PACA
Proceedings of the American Catholic Philosophical Association	PACPhA
Proceedings of the American Philosophical Society	PAPhS
Proceedings of the Aristotelian Society	PAS
Proceedings of the Aristotelian Society. Supplementary Volume	PAS (Suppl.)
Proceedings of the British Academy	PBA
Proceedings of the Cambridge Philological Society	PCPhS
Proceedings of the Classical Association	PCA
Proceedings of the Royal Irish Academy. Section C, Archaeology, Celtic Studies, History, Linguistics, Literature	PRIA
Proceedings of the Virgil Society	PVS
Prometheus	Prometheus
Provence historique	PH
Prudentia	Prudentia
Przeglad historyczny	PHist
Puteoli	Puteoli
Pyrenae	Pyrenae
Quaderni catanesi di cultura classica e medievale	QCCCM
Quaderni catanesi di studi classici e medievali	QC
Quaderni del Museo archeologico F. Ribezzo di Brindisi	QMAB
Quaderni dell'Istituto di archeologia e storia antica dell'Università G. d'Annunzio, Chieti	QIASA
Quaderni dell'Istituto di filosofia, Università degli studi di Perugia, Facoltà di magistero	QIFP
Quaderni dell'Istituto di lingua e letteratura latina	QILL
Quaderni di archeologia della Libia	QAL
Quaderni di cultura e di tradizione classica	QCTC
Quaderni di filologia classica	QFC
Quaderni di storia	QS
Quaderni linguistici e filologici	QLF
Quaderni urbinati di cultura classica	QUCC
Quaderns de prehistorià i arqueologia de Castelló	CPAC
Quarterly Journal of Speech	QJS
Ramus	Ramus
Rassegna di filosofia	RassFilos
Rassegna storica salernitana	RSS
Recherches augustiniennes	RecAug
Recherches de science religieuse	RecSR
Recherches de théologie et philosophie médiévales	RecTh
Rechtshistoriches Journal	RJ
Recueil des notices et mémoires de la Société archéologique de Constantine	RSAC
Regulae Benedicti Studia	RBS
Religion	Religion
Religious Studies	RelStud
Renaissance Quarterly	RenQ
Rendiconti dell'Accademia delle scienze dell'Istituto di Bologna, Classe di scienze morali	RAIB
Rendiconti dell'Accademia di archeologia, lettere e belle arti di Napoli	RAAN
Rendiconti dell'Istituto lombardo, Classe di lettere, scienze morali e storiche	RIL
Rendiconti della Classe di scienze morali, storiche e filologiche dell'Accademia dei Lincei	RAL
Rendiconti della Pontificia accademia di archeologia	RPAA
Report of the Department of Antiquities of Cyprus	RDAC
Report of the Keio Institute of Cultural and Linguistic Studies	RKI
Res Publica Litterarum	RPL
Review of Metaphysics	RMeta
Review of Religion	RR
Revista de estudios clásicos	REC
Revista de estudios latinos	RELat
Revista de filosofía	RF (Argentina)
Revista de historia	RevHist
Revista de letras	RL
Revista española de lingüística	REspLing
Revista española de teología	RET
Revista latinoamericana de filosofía	RLAF
Revista portuguesa de arqueologia	RPA
Revista venezolana de filosofía	RVF
Revue africaine	RAf
Revue archéologique	RA
Revue archéologique de l'Est et du Centre-Est	RAE
Revue archéologique de l'Ouest	RAO
Revue archéologique de Narbonnaise	RAN
Revue archéologique de Picardie	RAPic
Revue archéologique du Centre de la France	RACF
Revue belge d'archéologie et d'histoire de l'art	RBA
Revue belge de numismatique et de sigillographie	RBN
Revue belge de philologie et d'histoire	RBPh
Revue bénédictine	RBen
Revue biblique	RBi
Revue d'ascétique et de mystique	RAM
Revue d'égyptologie	REgypt
Revue d'études ligures	RELig
Revue d'histoire de la pharmacie	RHPharm
Revue d'histoire des sciences	RHS
Revue d'histoire des textes	RHT
Revue d'histoire du droit	RHD
Revue d'histoire ecclésiastique	RHE
Revue d'histoire et de philosophie religieuses	RHPhR
Revue de géographie de Lyon	RGL
Revue de l'enseignement philosophique	REPh
Revue de l'histoire des religions	RHR
Revue de l'Université de Bruxelles	RUB
Revue de métaphysique et de morale	RMM
Revue de philologie, de littérature et d'histoire anciennes	RPh
Revue de philosophie ancienne	RPhA
Revue de Qumran	RQ
Revue de synthèse	RS
Revue de théologie et de philosophie	RThPh
Revue des études anciennes	REA
Revue des études arméniennes	REArm
Revue des études augustiniennes	REAug
Revue des études byzantines	REByz
Revue des études grecques	REG
Revue des études juives	REJ
Revue des études latines	REL
Revue des études sud-est européennes	RESE
Revue des questions scientifiques	RQS
Revue des sciences humaines	RSHum
Revue des sciences philosophiques et théologiques	RSPh
Revue des sciences religieuses	RSR
Revue du moyen âge latin	RMAL
Revue du Nord	RdN
Revue du Nord. Archéologie de la Picardie et du Nord de la France	RdN(archéol)
Revue française d'histoire des idées politiques	RFHIP
Revue historique	RH
Revue historique de droit français et étranger	RD
Revue historique vaudoise	RHV
Revue hittite et asianique	RHA
Revue Informatique et statistique dans les sciences humaines	RISSH
Revue internationale d'onomastique	RIO
Revue internationale de philosophie	RIPh
Revue internationale des droits de l'antiquité	RIDA
Revue numismatique	RN
Revue philosophique de la France et de l'étranger	RPhilos
Revue philosophique de Louvain	RPhL
Revue suisse d'art et d'archéologie	RSAA
Revue théologique de Louvain	RThL
Revue universitaire	RU
Rheinisches Museum für Philologie	RhM
Rhetoric Review	RhetR
Rhetoric Society Quarterly	RSQ
Rhetorica	Rhetorica
Rhetorik	Rhetorik
Ricerche di storia religiosa	RicSRel
Ricerche linguistiche	RicLing
Ricerche teologiche	RicTeol
Riggisberger Berichte	RigBer
Rinascimento	Rinascimento
Rivista archeologica dell'antica provincia e diocesi di Como	RAComo
Rivista biblica	RivBibl
Rivista degli studi orientali	RSO
Rivista dell'Istituto nazionale di archeologia e storia dell'arte	RIA
Rivista di archeologia	RdA
Rivista di archeologia cristiana	RAC
Rivista di cultura classica e medioevale	RCCM
Rivista di filologia e di istruzione classica	RFIC
Rivista di filosofia	RF (Bologna)
Rivista di filosofia neoscolastica	RFN
Rivista di storia della Chiesa in Italia	RSCI
Rivista di storia della filosofia	RSF
Rivista di storia e letteratura religiosa	RSLR
Rivista di studi bizantini e neoellenici	RSBN
Rivista di studi bizantini e slavi	RSBS
Rivista di studi classici	RSC
Rivista di studi fenici	RStudFen
Rivista di studi liguri	RSL
Rivista di studi pompeiani	RSP
Rivista internazionale di filosofia del diritto	RIFD
Rivista italiana di numismatica e scienze affini	RIN
Rivista storica dell'antichità	RSA
Rivista storica italiana	RSI
Roczniki humanistyczne. 3, Filologia klasyczna	RHum
Roczniki humanistyczne. Filologia klasyczna	RoczHum
Romania	Romania
Romanische Forschungen	RomForsch
Romanitas	Romanitas
Romanobarbarica	RomBarb
Römische Quartalschrift für christliche Altertumskunde und für Kirchengeschichte	RQA
Römisches Österreich	RÖ
Rudiae	Rudiae
Saalburg-Jahrbuch	SJ
Sacris Erudiri	SEJG
Saeculum	Saeculum
Saguntum	Saguntum
Salesianum	Salesianum
Sandalion	Sandalion
Sapienza	Sapienza
Sborník prací Filosofické fakulty Brnenské University. Rada archeologicko-klasická	SPFB
Sborník prací Filosofické fakulty Brnenské University. Rada klasická	SPFB(klas)
Schede medievali	SMed
Scholia	Scholia
Schweizerische Münzblätter (Gazette numismatique suisse)	GNS
Schweizerische numismatische Rundschau	SNR
Schweizerische Zeitschrift für Geschichte	SZG
Scientia	Scientia
Scripta Classica Israelica	SCI
Scriptorium	Scriptorium
Scrittura e civiltà	S&C
Second Century	SCent
Seia	Seia
Seminari romani di cultura greca	SemRom
Semitica	Semitica
Siculorum Gymnasium	SicGymn
Sileno	Sileno
Sitzungsberichte der Bayerischen Akademie der Wissenschaften, Philosophisch-historische Klasse	SBAW
Sitzungsberichte der Deutschen Akademie der Wissenschaften zu Berlin, Klasse für Philosophie, Geschichte, Staats-, Rechts- und Wirtschaftswissenschaften	SDAW
Sitzungsberichte der Heidelberger Akademie der Wissenschaften, Philosophisch-historische Klasse	SHAW
Sitzungsberichte der Österreichischen Akademie der Wissenschaft in Wien, Philosophisch-historische Klasse	SAWW
Society for Ancient Medicine Review	SAMR
Sophia	Sophia
Sources: Travaux historiques	STHist
Southern Journal of Philosophy	SJPh
Sovetskaja arheologiâ	SA
Speculum	Speculum
Sprachkunst	Sprachkunst
Stadion	Stadion
Stemma	Stemma
Storia della storiografia	SStor
Storiografia	Storiografia
Studi classici e orientali	SCO
Studi e materiali di storia delle religioni	SMSR
Studi e ricerche dell'Istituto di civilità classica, cristiana, medievale	SRIC
Studi e saggi linguistici	SSL
Studi etruschi	SE
Studi genuensi	SG
Studi italiani di filologia classica	SIFC
Studi italiani di linguistica teorica e applicata	SILTA
Studi magrebini	StudMagr
Studi medievali	StudMed
Studi micenei ed egeo-anatolici	SMEA
Studi orientali e linguistici	SOL
Studi romagnoli	StudRomagn
Studi romani	StudRom
Studi salentini	StudSal
Studi sardi	SS
Studi storici	StudStor
Studi umanistici piceni	StudUmanistPiceni
Studi urbinati di storia, filosofia e letteratura	StudUrb
Studi urbinati. Serie B, Scienze umane e sociali	StudUrb(B)
Studia et Documenta Historiae et luris	SDHI
Studia Historica. Historia antigua	SHHA
Studia Linguistica	SL
Studia Monastica	StudMon
Studia Oliveriana	SOliv
Studia Patavina	StudPat
Studia Philologica Salmanticensia	SPhS
Studia Philologica Valentina	SPhV
Studia Philonica Annual	StudPhilon
Studia Philosophica	StudPhil
Studia Picena	StudPic
Studia Theologica	STh
Studia Troica	ST
Studia Zamorensia	SZ
Studien zum Buch- und Bibliothekswesen	SBB
Studies in History and Philosophy of Science	SHPS
Studies in Language	StudLang
Studies in Philology	SPh
Studies in Religion	SR
Studii clasice	StudClas
Studium Generale	Studium Generale
Studium Ovetense	StudOv
Stylus	Stylus
Sudhoffs Archiv	Sudhoffs Archiv
Suisse primitive	SP
Syllecta Classica	SyllClass
Symbolae Osloenses	SO
Symbolae Philologorum Posnanensium	SPhP
Symbolon	Symbolon
Symposion	Symposion
Synthesis	Synthesis
Syria	Syria
Tabona	Tabona
Talanta	Talanta
Taras	Taras
Technology and Culture	T&C
Teiresias	Teiresias
Tekmeria	Tekmeria
Temenos	Temenos
Text & Presentation	T&P
Thalès	Thalès
The Classical Quarterly	CQ		
The Classical Review	CR		
The Journal of Roman Studies	JRS		
Theological Studies	ThS
Theologie und Philosophie	Th&Ph
Theologische Literaturzeitung	ThLZ
Theologische Quartalschrift	ThQ
Theologische Revue	ThRev
Theologische Rundschau	ThRdschau
Theologische Zeitschrift	ThZ
Theoria	Theoria
Thetis	Thetis
Thomist	Thomist
Tijdschrift voor filosofie	TF
Tijdschrift voor geschiedenis	TG
Tijdschrift voor philosophie	TPh
Times Literary Supplement	TLS
Topoi	Topoi (Dordrecht)
Topoi: Orient-Occident	Topoi (Lyon)
Traditio	Traditio
Transactions of the American Philological Association	TAPhA
Transactions of the American Philosophical Society	TAPhS
Transactions of the Philological Society	TPhS
Travaux du Cercle linguistique d'Aix-en-Provence	TCLA
Travaux et mémoires du Centre de recherches d'histoire et civilisation byzantines	T&MByz
Travaux neuchâtelois de linguistique	TRANEL
Trésors monétaires	TMon
Trierer Zeitschrift für Geschichte und Kunst des Trierer Landes und seiner Nachbargebiete	TZ
Trinity Journal	TJ
Trivium	Trivium
Tyche	Tyche
Ugarit-Forschungen	UF
Uranie	Uranie
Vallesia	Vallesia
Veleia	Veleia
Verbum	Verbum
Verbum Caro	Verbum Caro
Verbum Domini	Verbum Domini
Vergilius	Vergilius
Verkundigung und Forschung	V&F
Vestnik drevnej istorii (Revue d'histoire ancienne)	VDI
Vestnik Leningradskogo universiteta, Serija 2, Istorija	VLUist
Vestnik Leningradskogo universiteta, Serija 6, Filosofija	VLUfilos
Vestnik Moskovskogo universiteta (Filologicheskaja sexcija)	VMUfilol
Vestnik Moskovskogo Universiteta (Filosoficheskaja sexcija)	VMUfilos
Vestnik Moskovskogo Universiteta (Istoricheskaja sexcija)	VMUist
Vetera Christianorum	VetChr
Vetus Testamentum	VT
Viator	Viator
Vichiana	Vichiana
Vigiliae Christianae	VChr
Visible Religion	VRel
Vita Latina	VL
Vivarium	Vivarium
Vivens Homo	Vivens Homo
Voces	Voces
Voprosy âzykoznaniâ (Problèmes de linguistique)	VopÂz
Voprosy filosofii (Problèmes de philosophie)	VopFilos
Voprosy istorii (Problèmes d'histoire)	VopIst
Vox Latina	VoxLat
Vox Patrum	VoxP
Vox Romanica	VR
Wiener humanistische Blätter	WHB
Wiener Studien	WS
Word	Word
Wort und Dienst	W&D
Würzburger Jahrbücher für die Altertumswissenschaft	WJA
Yale Classical Studies	YClS
Yale Journal of Criticism	YJC
Yale University Library Gazette	YLG
Zeitschrift der Deutschen Morgenländischen Gesellschaft	ZDMG
Zeitschrift der Savigny-Stiftung für Rechtsgeschichte. Romanistische Abteilung	ZRG
Zeitschrift des Deutschen Palästina-Vereins	ZPalV
Zeitschrift für antikes Christentum	ZAC
Zeitschrift für Archäologie	ZfA
Zeitschrift für ägyptische Sprache und Altertumskunde	ZÄS
Zeitschrift für die alttestamentliche Wissenschaft	ZATW
Zeitschrift für die neutestamentliche Wissenschaft und die Kunde der älteren Kirche	ZNTW
Zeitschrift für katholische Theologie	ZKTh
Zeitschrift für Kirchengeschichte	ZKG
Zeitschrift für Papyrologie und Epigraphik	ZPE
Zeitschrift für philosophische Forschung	ZPhF
Zeitschrift für Religions- und Geistesgeschichte	ZRGG
Zeitschrift für romanische Philologie	ZRPh
Zeitschrift für Semiotik	ZS
Zeitschrift für vergleichende Sprachforschung	ZVS
Zentralblat für Bibliothekswesen	ZBB
Zephyrus	Zephyrus
Zetesis	Zetesis
Ziva antika (Antiquité vivante)	ZAnt
Zprávy jednoty klasickych filologu	ZJKF
Ìnozemna filologìâ (Philologie étrangère)	ÌnFìl